  16  16  16  16   1   1   1   1   1   1   1   1   1   1   1   1   1   1   1   1   1   1   1   1   1   1   1   1   1   1   1   1
  16  16  16   1   1  16   1   1   1   1   1   1   1   1   1   1   1   1   1   1   1   1   1   1   1   1   1   1   1   1   1   1
 129 129 129 129 144 128 144 128 129 129 144 128 144 128 144 128 129 129 129 144 128 129 129 144 128 129 129 144 128 144 128 129
   1   1   1   1   1   1   1  12  13   1   1   1   1  12  13   1   1   1   1   1   1   1   1   1   1   1  12  13   1   1   1  12
  10  11   1   1   1   1   1  28  29  12  13   1   1  28  29   1   1   1   1   1   1   1   1   1   1   1  28  29   1  12  13  28
  26  27  12  13   1   1   1   1   1  28  29   1   1   1   1   1   1   1   1   1   1   1   1   1   1  12  13   1   1  28  29   1
  42  43  28  29  12  13   1   1   1   1   1   1   1   1   1   1   1   1   1   1   1   1   1   1   1  28  29   1   1   1  12  13
   1   1   1   1  28  29  16   1   1   1   1   1   1   1   1   1  16  16   1   1   1   1   1   1   1   1   1   1   1   1  28  29
   1  16   1   1   1  16  16  16   1   1   1   1   1   1   1   1   1   1   1   1   1   1   1   1   1   1   1   1   1   1   1  12
   1   1   1   1   1   1   1   1   1   1   1   1   1  16  16   1  16   1   1   1   1   1   1   1   1   1   1   1   1   1   1  28
   1   1   1   1   1   1  16  16   1   1   1   1   1   1   1   1   1   1   1   1   1   1   1   1   1   1   1   1   1   1   1  16
   1   1   1   1   1   1  16  16   1   1 111 191 127   1   1   1   1   1   1   1 130 131  16   1  16   1   1   1   1   1   1 130
   1   1   1   1   1   1  16  16   1   1 143 175 159  16  16  16   1  16  16   1 146 147  16   1  16   1   1   1   1   1   1 146
   1   1   1   1   1   1  16  16   1   1   1   1   1   1   1  16  16  16  16 130 132 132 131   1  16   1   1   1   1  16   1 162
   1   1   1   1   1  16  16  16   1   1   1   1   1  16  16  16   1  16  16 146 132 132 147  16  16   1   1   1   1   1 130 131
   1   1   1   1   1   1  16  16   1   1   1   1   1   1  16  16  16  16  16 162 148 148 163 130 131   1   1   1   1   1 146 147
   1   1   1   1  16   1   1   1   1   1   1   1   1   1   1  12  13  16   1  16   1  16  16 146 147   1   1  16  16   1 162 163
   1   1   1   1   1   1   1   1   1   1   1   1   1   1   1  28  29  16  16  16   1   1   1 162 163   1   1   1   1   1   1 130
   1   1   1 130 131 130 131   1   1   1   1   1   1   1 111 191 191 127  16  16  16   1   1   1   1   1   1   1   1   1   1 146
   1   1   1 146 147 146 147   1   1   1   1   1   1   1 207 239 239 239 191 127  16   1   1   1   1   1  16   1   1  12  13 162
   1   1   1 162 163 162 163   1   1   1   1  12  13   1 207 239 175 159 143 159  16   1   1   1   1   1   1  16   1  28  29  12
   1   1   1  16 130 131   1   1   1  12  13  28  29   1 207 223   1   1   1  16   1  16   1   1   1   1   1   1   1   1   1  28
   1   1 130 131 146 147   1  12  13  28  29   1   1   1 207 223   1  12  13   1   1 130 131   1   1   1   1   1   1   1  12  13
   1   1 146 147 162 163   1  28  29   1   1   1   1   1 207 223   1  28  29   1   1 146 147   1  12  13  12  13   1   1  28  29
  10  11 162 163   1   1   1   1  12  13   1   1   1 111 239 223   1   1   1   1  16 162 163   1  28  29  28  29   1  12  13  12
  26  27   1   1   1   1   1   1  28  29 111 191 191 239 239 223   1   1   1   1   1   1   1   1   1   1   1   1   1  28  29  28
  42  43   1  12  13   1   1   1   1   1 143 175 175 175 175 159   1   1   1   1   1   1   1   1   1   1   1   1   1   1  12  13
   1   1   1  28  29   1 141   1   1   1   1   1   1   1   1   1   1   1 141   1   1   1   1   1   1   1   1   1   1   1  28  29
 140 142 124 125 125 140 126 142 140 142 125 125 125 125 124 125 125 140 126 142 125 125 124 125 125 125 140 142 125 125 124 125
 126 126 126 126 126 126 126 126 126 126 126 126 126 126 126 126 126 126 126 126 126 126 126 126 126 126 126 126 126 126 126 126
