   0   0   0   0   0   0   0   0   0   0   0   0   0   0   0   0   0   0   0   0   0   0   0   0   0   0   0   0   0   0   0   0
   0   0   0   0   0   0   0   0   0   0   0   0   0   0   0   0   0   0   0   0   0   0   0   0   0   0   0   0   0   0   0   0
   0   0   0   0   0   0   0   0   0   0   0   0   0   0   0   0   0   0   0   0   0   0   0   0   0   0   0   0   0   0   0   0
   0   0   0   0   0   0   0   0   0   0   0   0   0   0   0   0   0   0   0   0   0   0   0   0   0   0   0   0   0   0   0   0
 129 129 129 129 129 129 144 128 129 129 129 129 129 144 128 144 128 129 129 144 128 129 129 129 129 129 129 144 128 144 128 129
   1   1   1   1   1   1  12  13   1   1   1   1   1   1   1   1   1   1   1   1   1   1   1   1   1   1   1   1   1   1   1   1
   1  10  11   1   1   1  28  29   1   1   1   1   1   1   1   1   1   1   1   1   1   1   1   1  10  11  10  11   1   1  10  11
   1  26  27   1   1   1  16   1   1   1   1   1   1   1   1   1  16  16   1   1   1   1   1   1  26  27 133 134   1   1  26  27
   1  42  43   1   1   1  16  16   1   1   1   1   1   1   1   1   1   1   1   1   1   1   1   1  42  43   1   1   1   1 135 136
   1   1   1   1   1   1   1   1   1   1   1   1 130 131   1   1  16   1   1   1   1   1   1   1   1   1  16 130 131   1  42  43
   1   1   1   1   1   1  16  16  12  13   1   1 146 147   1   1   1   1   1   1   1   1  12  13   1 130 131 146 147   1   1  16
   1   1   1   1   1   1  16  16  28  29  12  13 162 163   1   1 111 191 191 191 127  16  28  29  16 146 147 162 163   1   1   1
   1   1   1   1   1   1  16  16 130 131  28  29  16  16  16  16 207 239 239 239 239 127  16   1  16 162 163 130 131   1   1   1
   1   1   1   1   1   1  16  16 146 147  16  16   1   1   1  16 207 239 239 239 239 223   1   1  16  16   1 146 147  16   1   1
   1   1   1   1   1  16  16  16 162 163  16  16  16  16  16  16 207 239 239 239 239 223   1  16  16 130 131 162 163   1   1   1
   1   1   1   1   1   1  16  16   1   1 130 131   1   1  16   1 143 239 239 239 239 223  16  16   1 146 147   1   1   1   1   1
   1   1   1   1  16   1   1   1   1   1 146 147   1   1   1   1  16 143 175 175 175 159  16 130 131 162 163  16  16   1   1   1
   1   1   1   1   1   1   1   1  12  13 162 163   1   1   1  16   1  16  16  16   1   1  16 146 147   1   1   1   1   1   1   1
   1   1   1   1  16  16  16   1  28  29   1   1   1   1   1  16   1   1  16  16  16   1  16 162 163   1   1   1   1   1   1   1
   1   1   1   1   1   1  16  12  13  12  13   1   1   1   1   1   1   1   1   1  16   1   1   1   1   1  16   1   1   1   1   1
   1   1   1   1   1   1   1  28  29  28  29   1   1  12  13  12  13   1   1   1  16   1   1   1   1   1   1  16   1   1   1   1
   1   1   1  16   1   1   1   1   1  12  13   1   1  28  29  28  29   1   1  16   1  16   1   1   1   1   1   1   1   1   1   1
   1   1   1   1   1   1   1   1   1  28  29 130 131   1   1   1   1   1   1   1   1   1   1   1   1   1   1   1   1   1   1   1
   1   1   1   1   1   1   1   1   1   1   1 146 147 130 131   1   1   1   1   1   1   1  16  16   1   1   1   1   1   1   1   1
   1   1   1   1  10  11   1   1   1   1   1 162 163 146 147   1   1   1 130 131  16   1  10  11   1   1   1   1  10  11   1  16
   1   1  10  11  26  27   1   1   1   1   1   1   1 162 163   1   1   1 146 147   1   1  26  27  10  11   1   1  26  27  10  11
   1   1  26  27  42  43   1   1   1   1   1   1   1   1  12  13  12  13 162 163   1   1 135 136 133 134   1   1  42  43  26  27
   1   1  42  43   1   1   1   1 141   1   1   1   1   1  28  29  28  29   1   1   1   1  42  43   1   1 141   1   1   1  42  43
 140 142 125 140 142 125 125 140 126 142 125 125 125 124 125 125 125 124 125 125 140 142 124 125 125 140 126 142 125 125 124 125
 126 126 126 126 126 126 126 126 126 126 126 126 126 126 126 126 126 126 126 126 126 126 126 126 126 126 126 126 126 126 126 126
